#######
#J..P.#
#.###.#
#..@#.#
#@#.@.#
#######