##########
#......@##
#.#####.P#
#..#.@#.##
#.@...#..#
####...#@#
#@.J.#...#
#..###..@#
##########
